1111111111111111
1000000000000001
1C0N000000000001
10000E0000000001
1000000000000001
10000000N0000001
1000000000000001
1000000000000001
1000N00000000001
1000000000000001
100000N000000001
1000000000000001
100P000000000001
1000000000000001
1000000000000001
1111111111111111
