111111
100101
1P0001
100001
100101
1C0EC1
111111
