1111111111111111111
1111111111111111111
1111111111111111111
1P0E00C001110000111
1000111110000101111
1111111111111111111
