1111111111111111111
1111111111111111111
1111111111111111111
1P0E00C00111N000111
1000000000000101111
1000000000000101111
1000000000000101111
1000000000000101111
1000000000000101111
1000000000000101111
1000000000000101111
1000000000000101111
1000000000000101111
1000000000000101111
1000000000000101111
1000000000000101111
1000000000000101111
1000000000000101111
1000000000000101111
1000000000000101111
1000000000000101111
1000000000000101111
1000000000000101111
1000000000000101111
1000000000000101111
1000000000000101111
1000000000000101111
1000000000000101111
1000000000000101111
1000000000000101111
1000000000000101111
1000000000000101111
1000000000000101111
1000000000000101111
1000000000000101111
1000000000000101111
1000000000000101111
1000000000000101111
1000000000000101111
1000000000000101111
1000000000000101111
1000000000000101111
1000000000000101111
1000000000000101111
1000000000000101111
1000000000000101111
1000000000000101111
1000000000000101111
1000000000000101111
1000000000000101111
1000000000000101111
1000000000000101111
1000000000000101111
1000000000000101111
1000000000000101111
1000000000000101111
1000000000000101111
1000000000000101111
1000000000000101111
1000000000000101111
1000000000000101111
1000000000000101111
1000000000000101111
1000000000000101111
1000C00000000101111
1000000000000101111
1000000000000101111
10000000000C0101111
1000000000000101111
1000000000000101111
10000000000C0101111
1000000000000101111
1000000000000101111
1000000000000101111
1000000000000101111
1000000000000101111
100C000000000101111
1000000000000101111
1000000000000101111
1000000000000101111
1000000000000101111
1000000000000101111
1000000000000101111
1000000000000101111
1000000000000101111
1000000000000101111
1000000000000101111
1000000000000101111
1000000000000101111
1000C000000C0101111
1000000000000101111
1000000000000101111
1000000000000101111
1000000000000101111
1000000000000101111
1000000000000101111
1000000000000101111
1000000000000101111
1000000000000101111
1000000000000101111
1000000000000101111
1000000000000101111
1000000000000101111
1000000000C00101111
1000000000000101111
1111111111111111111
