1111111111
10C01C0101
101C000001
1C11010001
101001C001
1010000001
10C00C1111
1000000E01
100P0CC111
1111111111
