1111111111
10C01C0101
101C000001
1C11010001
101001C001
1010000001
10C00C00C1
100E001001
100P0CC001
1111111111
